111111111111111111111111111
1P000C0000C000C00C000000111
1111111C11111100000C0000001
10000E000001110000000000001
10C0C0011011101111110011111
11C10111000C100C000000N0001
1111N1110011110000000C00001
111110011N11110N000C0000001
111111111111111111111111111