111111111111111111111111111
1N0000000000P00C00C00000011
1111111100011100000C0000001
10000E000001110000000000001
10C0C0011011101111110011111
11C10111000C100C0N000000011
111101110011110000000C00001
1111100110111100000C0000001
111111111111111111111111111